ist	VRB|VEX	sîn	VERB
zwîvel	NOM	zwîvel	NOUN
herzen	NOM	herze	NOUN
nâchgebûr	NOM	nâchbûre	NOUN
,	0	,	PUNCT	
daz	ART|CNJ	daz	PRON
muoz	VRB|VEM	müezen	AUX
der	ART	der	DET
sêle	NOM	sêle	NOUN
werden	VRB|VEX	werden	VERB
sûr	ADJ|ADV	sûr	ADJ
,	0	,	PUNCT
gesmaehet	VRB	smæhen	ADJ
und	CNJ	und	CONJ
gezieret	ADJ|VRB	zieren	ADJ
ist	VRB|VEX	sîn	VERB
swâ	CNJ|IPA	swâ	ADV
sich	PRO	sich	PRON
parrieret	ADJ	parrieren	VERB
unverzaget	ADJ|ADV|NEG	unverzaget	ADJ
mannes	NOM	man	NOUN
muot	NOM	muot	NOUN
,	0	,	PUNCT
als	CNJ	als	SCONJ
agelstern	NOM	agelster	VERB
varwe	NOM|ADJ	varwe	NOUN
tuot	VRB	tuon	VERB
.	0	.	SPUNCT
der	ART	der	PRON
mac	VRB|VEM	mügen	AUX
dennoch	ADV|CNJ	dannoch	ADV
wesen	NOM|VRB	wesen	VERB
geil	NOM|ADJ	geil	ADJ
,	0	,	PUNCT
wande	CNJ	wande	CONJ
an	PRP	an	ADP
im	PRO	er	PRON
sint	VRB|VEX	sîn	VERB
beidiu	ADJ	beide	ADJ
teil	NOM	teil	NOUN
,	0	,	PUNCT
des	ART	der	DET
himels	NOM	himel	NOUN
und	CNJ	und	CONJ
der	ART	der	DET
helle	NOM	helle	NOUN
.	0	.	SPUNCT
der	ART	der	DET
unstaete	NOM|ADJ|NEG	unstæte	ADJ
geselle	NOM	geselle	NOUN
hât	VRB|VEX	haben	VERB
die	ART	die	DET
swarzen	ADJ	swarz	ADJ
varwe	NOM|ADJ	varwe	NOUN
gar	ADJ|ADV	gar	ADV
und	CNJ	und	CONJ
wirt	VRB|VEX	werden	AUX
ouch	CNJ	ouch	ADV
nâch	ADJ|ADV	nâch	ADP
der	ART	der	DET
vinster	NOM|ADJ	vinster	NOUN
var	VRB	varn	VERB
:	0	:	SPUNCT
